WWWWWWWWWWWWXWWW
W---D---D---B--W
W---W-WWW---W--W
W---W---WWDWWDWW
WDWWWWW-W---W--W
W---W---W---W--W
W---WWDWWWW-W--W
W---R---W---W--W
W--RR---W---W--W
W--RWWWWWWWDWWWW
WWDWWW---B-----W
W----W---WWWTWWW
X----W---W-TTTTX
W----W--VW-TTT-W
W----R--PW-TT--W
WWWWPPPPPWWWXWWW
