WWWWWWWWWWWWXWWW
WD-D-WBBBBBBBBBW
W-D-DWD-D-D-D-DW
WD-D-WBBBBBBBB-W
WWDWWWD-D-D-D-DW
WD-D-W-D-D-D-D-W
W-D-DWBBB-WWWWWW
WD-D-WPD-DWDZZZW
W-D-DWPPD-W-DZZW
WWWDWW-PPDWD-D-W
W-D-DWPPP-W-D-DW
WD-D-DT--DWD-D-W
X-D-DWP-D-D-D-DX
WD-D-WPD-DWD-D-W
WVD-PPD-D-W-D-DW
WPPPPWWWWWWWXWWW
