WWWWWWWWWWWWXWWW
WFBBBWRRR---BBBW
WF---D--RP-----W
WF--WWW-RFP--PPW
WWWWW-R-R-PP---W
WVTVTVW-W-RP---W
WTTT--W-W---P--W
WTT---W-W-W--BBW
WWWWW-D-D-W----W
WSTTW-W-W-W----W
W-TTW-W-WWWWWWWW
W--TW-W-WB-DZWWW
XDWWW-W-D--W-W-X
W-TT--W-W--W-W-W
WTT---W-W--W-D-W
WWWWWRWWWWWWXWWW
