WWWWWWWWWWWWXWWW
W--------------W
W--------------W
W--------------W
W---B-----B----W
W--------------W
W--------------W
W--------------W
W---B-----B----W
W--------------W
W--------------W
W--------------W
X--------------X
W--------------W
W--------------W
WWWWWWWWWWWWXWWW
