WWWWWWWWWWWWXWWW
WBBBBBBBBBBB-W-W
WR-----------W-W
WWRTT-PP-----W-W
WWWRBPPPBBBB-W-W
WV----PP-----W-W
W------------W-W
WBBBBBBBBBBB-W-W
WTTT---------WDW
WBBBBBBBBBBB---W
W--------------W
WWWWWDWWWWWWDWWW
X----------TTT-X
W---------TT---W
WFFF-----TTT---W
WWWWWWWWWWWWXWWW
