WWWWWWWWWWWWXWWW
W--------------W
W--------------W
W--------------W
WSSSS----------W
W--------------W
W------S-------W
W-----ZS-------W
W--------------W
W--------------W
W--------------W
W--------TV----W
X--------------X
W--------------W
W--------------W
WWWWWWWWWWWWXWWW
