WWWWWWWWWWWWXWWW
W------------W-W
W---BBBWWW-WWW-W
W-WWWWWW-W-WP--W
W--------W-----W
W-WWWWWWWW-WWWWW
W--------W-D--PW
WWWWWWWW-W-W--PW
WW-----W-W-WWWWW
WP-PDW-W-W-D--SW
WP-P-W-W-W-W---W
WP-W-W-W-W-WWWWW
X--W-W-W-W-D---X
WPWW-W-W-W-WWWDW
WWW--W---W-W---W
WWWWWWWWWWWWXWWW
