WWWWWWWWWWWWXWWW
W--------------W
W--WWWWWWWWWWWWW
W-W------------W
W---WWWW-WWWWW-W
W-WWW----W---W-W
W-W---WWWW-W-WPW
W-W-WWWP---WTWPW
W-W-WP---PVWTWPW
W-W-WW--WWWWTWPW
W-W-W-BBW----WKW
W-W-W---W-WW-WWW
X-W-W--WW-WW---X
WWWDW--W--WWWW-W
WV-----WZWWZ---W
WWWWWWWWWWWWDWWW
