WWWWWWWWWWWWXWWW
W--------------W
W--------------W
W--WWWWWWWWWW--W
W--D--------W-TW
W--W--------W-TW
W--W--WWWW--W--W
W--W--W-SW--WT-W
W--W--W--W--WT-W
W--W--WDWW--WT-W
W--W--------WT-W
W--W--------W--W
X--WWWWWWWWWW-ZX
W----------TTTTW
W-----TTTT--ZTTW
WWWWWWWWWWWWXWWW
