WWWWWWWWWWWWXWWW
WZ--W-----W----W
W---W-----W----W
W---W-----W----W
W---D-----D----W
WWDWWWWDWWWWWDWW
W---D-----W----W
W---R-----W----W
W---RRWWWDW----W
W--RW-----W----W
W---W-----WBWWWW
WWWWWDWWWWW-W--W
X---W-----W-W--X
W---D-----W-D--W
W---W-----W-W--W
WWWWWWWWWWWWXWWW
