WWWWWWWWWWWWXWWW
W----------W-W-W
W--WWW-WWW-W-W-W
W----W---W---W-W
W----W---W---W-W
W----W---W-W-W-W
W-WWWW-WWW-W---W
W----W---W-W-W-W
W-W--W---W-W-W-W
W-WWWWWWWW-W-W-W
W----------W-W-W
WWWWW---WWWW-WWW
X--------------X
WWWWW---WWWW---W
W----------W---W
WWWWWWWWWWWWXWWW
