WWWWWWWWWWWWXWWW
W---------------W
W---------------W
W---------------W
W---------------W
W---------------W
W----------PPPPPW
W---------------W
W---------------W
W---------------W
W---------------W
W---------------W
X-D-------------X
W---------------W
W---------------W
WWWWWWWWWWWWXWWW