WWWWWWWWWWWWXWWW
W----W---------W
W----W---------W
W----W---------W
W----WDWWDWWWDWW
W----W-W---W---W
W----D-W---W---W
W----W-W---W---W
WWDWWW-WWDWWWWWW
W----W-W-------W
W----W-W-------W
W----W-W-------W
X----W-W-------X
W----W-WWWWWWWWW
W----W--------WW
WWWWWWWWWWWWXWWW
