WWWWWWWWWWWWXWWW
W--W---WB--W-W-W
W--D---W---D-W-W
W--W---D---W-W-W
W-WWDWWWWWWW-W-W
W-W--W-----W-W-W
W-W--W-PP--D-W-W
W-W--WPPW--W-W-W
W-WWWWWWWWWW-W-W
W-WW-------D-D-W
W-WW-------W-W-W
WDWWWPPWWWWWPWWW
X-WWW----------X
W-BBWWWWWWWW-WWW
W----------D-W-W
WWWWWWWWWWWWXWWW
