WWWWWWWWWWWWXWWW
W----WWWW--W---W
W----W--WWWW---W
W----W-----B---W
WDWWDWDRRWWWWWWW
W--W---R--W----W
WP--WDWW--D-WWDW
WP--W-W---W-W--W
W-W-W-WDWWW-WV-W
W-W-W-R---W-WWWW
W-W-W-W---W----W
WWWBW-RRWDWWTTWW
X---W-W---W----X
W---W-W---W----W
W---W-D---W----W
WWWWWWWWWWWWXWWW
